AD = Andorra
AL = Albania
AM = Armenia
AT = Austria
AZ = Azerbaijan
BA = Bosnia and Herzegovina
BE = Belgium
BG = Bulgaria
BY = Belarus
CH = Switzerland
CY = Cyprus
CZ = Czech Republic
DE = Germany
DK = Denmark
DZ = Algeria
EE = Estonia
ES = Spain
FI = Finland
FR = France
GB = United Kingdom
GE = Georgia
GL = Greenland
GR = Greece
HR = Croatia
HU = Hungary
IE = Ireland
IL = Israel
IQ = Iraq
IR = Iran
IS = Iceland
IT = Italy
JO = Jordan
KZ = Kazakhstan
LB = Lebanon
LI = Liechtenstein
LT = Lithuania
LU = Luxembourg
LV = Latvia
MA = Morocco
MC = Monaco
MD = Moldova
ME = Montenegro
MK = Macedonia
MT = Malta
NL = Netherlands
NO = Norway
PL = Poland
PT = Portugal
RO = Romania
RU = Russian Federation
SA = Saudi Arabia
SE = Sweden
SI = Slovenia
SK = Slovakia
SM = San Marino
SR = Suriname
SY = Syrian Arab Republic
TM = Turkmenistan
TN = Tunisia
TR = Turkey
UA = Ukraine
